基隆 : Keelung
汐止 : Xizhi
萬里 : Wanli
新店 : Xindian
土城 : Tucheng
板橋 : Banqiao
新莊 : Xinzhuang
菜寮 : Cailiao
林口 : Linkou
淡水 : Tamsui
士林 : Shilin
中山 : Zhongshan
萬華 : Wanhua
古亭 : Guting
松山 : Songshan
大同 : Datong
桃園 : Taoyuan
大園 : Dayuan
觀音 : Guanyin
平鎮 : Pingzhen
龍潭 : Longtan
湖口 : Hukou
竹東 : Zhudong
新竹 : Hsinchu
頭份 : Toufen
苗栗 : Miaoli
三義 : Sanyi
豐原 : Fengyuan
沙鹿 : Shalu
大里 : Dali
忠明 : Zhongming
西屯 : Xitun
彰化 : Changhua
線西 : Xianxi
二林 : Erlin
南投 : Nantou
斗六 : Douliu
崙背 : Lunbei
新港 : Xingang
朴子 : Puzi
臺西 : Taixi
嘉義 : Chiayi
新營 : Xinying
善化 : Shanhua
安南 : Annan
臺南 : Tainan
美濃 : Meinong
橋頭 : Qiaotou
仁武 : Renwu
鳳山 : Fengshan
大寮 : Daliao
林園 : Linyuan
楠梓 : Nanzi
左營 : Zuoying
前金 : Qianjin
前鎮 : Qianzhen
小港 : Xiaogang
屏東 : Pingtung
潮州 : Chaozhou
恆春 : Hengchun
臺東 : Taitung
花蓮 : Hualien
陽明 : Yangming
宜蘭 : Yilan
冬山 : Dongshan
三重 : Sanchong
中壢 : Zhongli
竹山 : Zhushan
永和 : Yonghe
復興 : Fuxing
埔里 : Puli
馬祖 : Matsu
金門 : Kinmen
馬公 : Magong
關山 : Guanshan
麥寮 : Mailiao
屏東(車城) : Car1
苗栗(交通) : Car2
苗栗(通霄) : Car3